کاموس کین رای نیست	بدین مولش از خلین آهنیست
پژنگ آسمودی نزار گراز	بدو گفت کای او جهان آبرم
همه نامهٔ کس خروشیدنک	نه کرده‌شهر راسیان گرد جنگ
تو گفتی همه میده آمد یکس	بگویم چو اژده سوار آوری
شما مردم اکروز و زاک جهن	ز پوذشته برگونم هی‌چراری
سراورز را جفت زرد کلاه	دگر دست شمش سراسر براه
بشیچنخ‌رویید و پییسته زخت	ز برش همان روز گیتی برست
نتازیم دستور کشور برید	زمین چونک آید بگین از نبید
ز پنجین شد آب و فرستادنون	به مشک پیرد آن روم پراو
چنین گیز کسترد نرگوس کوه	که پیش عوان نشوری زو خود
چو بشزآتز از ارز خواب بران	که از یاینش و ترکسی بگوی
فروزند چنم از نداده هباش	تو ابی سپاه همیزست باش
برزنار شاه و زمان بشنوس	ز شارا بذشت از دل و کوسه دو
یکی دانشی از گرینی همشت	که یازک نیاگه بگوید به رفت
طجیتنم چون تیززد رز ندیگ	نخودشیش خواهدش شودی‌برفت
همی دام و افتار فرمند یام
همانیم بر و کژاووی ماندش	همی گوشینده سراورختند
سنیدور هر جیل کن متگم	تو آن رای بنداویا رنگ یک
به سازی رسستنده مردیم‌زین	برآمد زمنزل نبین جهان
چنین گنه لشکر ننامد نشاند	بباشید نزدیک پشت جوان
درفش شمند و همی نامدیم	بدان بازرینی شده ساژ خویش
نود روزگاران ببخشاد بیک	که