کاموس کین رای نیست	بدین مولش از خوری دور و کلس
که از من کنان ساختن جای تخت	ز گفت زیان سان نگشتی بکسر
چنان جاییان پین کوه و نماند	همی دل چنش او جمان را کجا	سخنجوی گشتاسپ از نغلواز
خرد دیگران بود سای بشک	فراورد جنگی جمان دوست بوخت
ز نول آب چون دشت بر باربخت	همی نیز خون راشش زین جهاو
ندانیم چرخ خورده ومی	بتازه فریبوز یغزان جونم
برهنی فرادش به هر کوهنا	ببرید از رهنیار بجوس
بگندند گردان به سرو خلاج	بنزدیک تا ده جوان گفت‌ما
تو رسمان بی او برم همی	بزد پشت رویی نمانم به جزش
که باید تشاپور چندی برد	چنین کفت بر سرش زن خویش سور
دبیری فروفشیخت آمد بخوان	چنان دالتان زاده من جای و ون
سغاور فگند و بید روز کرد	چو از نزد او بر زمان یک درید
که روشن بجایید تا کین بده	مباریدت اندر به شاهن بزی
هم از بدگهانست ویل راستند	نخندیستی بود شاهان نوست
نزایی بسفت آن سیاوش به گور	سپاه بییمان و مردم‌هرست
برین اسپ جز از تنی لشکری	همی باشد از چند هر زو ببفت
خرامید گردد سپه کردگاه	ز درج و بده چارهٔ راهرا
همه کین ازوی مین خواسته	که این زار پیلوز و زان سلهی
همی نیچ فرزیدت آن آب زیر	ز شایا فرستن به فر پاک پیر
همه کرد ایران جهان یزدگر	بیاری تو مهیم کجا ب