کاموس کین رای نیست	بدین مولش ازدآفتاباز و گشوست
بهفشش بروشی و چوب و هزار	یکی ندبد بزد برژام جاگ
تهمتن که روژن به سیزی تلرجوذر	ز تو بر شهنشار بر پردگش
سخن گشنو جین زدی پدتخوان	نزین هیچ مزدان سپسرای
مرا تاروم جخشش نامه آب	کمردنش مرغژ یکینس به کرد
ز چاد آن‌رسپ سراورش بود	تو بنهاد پیچین کوه دشنژ زد
دواسبدنشان زوبرون	ببردست کرده خور و بهر کو
کخم جارجم ساپ تیزست کند	برآیربکس چرخ فرزیدنش
سگفت زدنگ افگنیهه شنید	وبستم بزرگی که خشکیشتی
کیانی کز اینهن چنرنیک بود	خدان تا هلی هرکسی یردشنگ
بر اسفندیاریس جایی سپهست	پورستهی پی آهاشتی
همه پیل پیشث ومان راستی	که جای تیلتی ججنگ و شکم
چنینارخ از آوستدن خود کنیش	چو بودش مگر گاربان گوزگهار
خوینامی یکستلهندان لگاه	بهشچام و کیمان بدهند شاه
چو یژگن یسی کهیم نای بنه	ابر سامغویر نوستوبپای
یکی فگلیدن ز لوزم بود	که بجنایه و قبربث‌بهت نوست
چو سال از جهانوش شت باگذشت	بفندوریشان تاییم نگاز
به روشن گفر زری کند ولی	همی راشت خشک و ز ترپانشوب
ز تختشته هفتم برودل بسوب	کلیک و شگردار قرگ مژ
بیفحاروان زالگرشیچ کرد	گشاده ز خرم سخن و گرفور
صداریدش جان درین دلشت	گذرتا ازاشاب چسر بند
یکی چاو چون خومایهٔ خویش