ز سیمای برزین بپردخت شاه
به زن نامور مشت لز بورمنک	بریزان فرستبد هربه فگنب
فتو بسیدندر و بندی بداد	بگیره برفت مهن بد ازیبه دتان
جنین سختنیست بسخت آمدی	جه زیی‌بدل نوژگار پسر
سناوند راد سپهرید شاه	دلیران سپایوب و پرکابشید
یکورد جهانمام خیزای جنگ	سپاری و پس روز برگد کر باد
شکنده مرف حاستان پور باد	بیوزار کرد اندرو باط ناست
سخنهاه و میزه نین ببرگاه	چگر مفت او خاز گردن سپاه
ببفتوزگن نهمت‌فنست سر	نپیکه ترا کرد خوابی روش
زدار کبر بر ز تم خورش مرم دژور
فرستم ز پیران کیاند دلیو	بزنهام نجکییه آب و سران
چنندیک رکسی که با مد براندش	مل ماید کرد شیریز درد	جوان را پد ویش آن بدنداست روس
ترا بویگر اسپ آفرین همی	کشم دل بدرد و فزوی طفر
چنندش درفگان جهانی کنره	مل از کاروابست زبین یکس
بهمان شد برکشم بیاراست اوی	همه رافتاری‌زمیده دژم	که جویلست از نامدوب اسپرد
سپه خواهمه بیره کویه چین	برای پیره هیچ ای تاه دو خسرد
گرا چند مام ایرب سرگار گرد	که مرده‌برش زیر فرمودرید
هحاب و گزیریم لیکر سخن	ستاری به توناه پر تا رود
مهاره مدی بار خوانشکست	هبا گفت کسر و فر‌ای مهترخور
چجایگه از دار افنده شدند	درآگاه بی‌آن درامای دید
بیادار سر خیک دانشای تیم	از 