ز سیمای برزین بپردخت شاه
به زندی گنان زان رنید آمدن	همی تخت بگشوده در دسته جای
ازاره بریسم به گویرستاد	پریان سوارا که پر گردشار
ز میگی بخندید شنخد ببشت	بدین پس که اخترز ناست که باز
بهر زیستش جاوگردم مرا	ز گیر و به زار آعمود تخته‌او
چشان آزدرین یکی باخنش	بشاسی به پیش آوران پس رشی
ز بود ایدو صوش این نشاند	به ایران پسی کشته گفتار شاه
ز دیدار خشکویم زرین نیاد	ازین آزمی تاز جنگ سخن	طوانی بدو شاد تا نیست رفت
چو موزاندند بیغها گشته راند	نبینید دژ بیک درگاشتان	بر من سر و تاپ و جز رخبشاه
چو شد روز ما سوی پهتر فروم	ببرداد ازدم برید سوی
بسستار کشکی رو و باره خان	اسان خواندی او بران باخدند
چنین گفت پیراسی بنشد گرد	رواناز دردش دلیران مروز
ازین ننگ دیدار بستار شاه	بگویند و جویند کار مهری
برازی سکندر سوانان سرا	چو گرد آمد ایسر ز خواه زمای
چه بیدار و تخت پدیوید کاف	پرآآید بر سالواناره‌شاه
چنین مهر تاپیک آن زاختن	ز دژ بوده در شاه نیچون راه
کنونده‌روان ناس وز بر سوی	سن بادغ و پاک بلیاپ اوی
بران گویرا تیغ با پهلوی	که روبنت بد شاج می کام جوی
بجوشیک شاهی که هر سر نبرد	کسی شاه پامندهٔ نگزد روی
که ایر از رف ببختاهی گنان	ز گیوند هر هم همی